NO       ./path_to_the_north_texture

SO           ./path_to_the_south_texture
F         220,100,0
WE       ./path_to_the_west_texture
C         225,30,0

EA ./path_to_the_east_texture























111 11
101111
101001
1000N1
111111

