NO       sprite/p_a_21.xpm

SO           sprite/p_a_14.xpm
WE       sprite/p_a_9_photo-resizer.ru.xpm
EA sprite/p_a_8_photo-resizer.ru.xpm
C         20,83,150
F         225,245,0


11111    1111111111111111111111111
10101    1000000000110000000000001
10N11    1011000001110000000000001
10001    1001000000000000000000001
1000111111110000011100000000000001
1000000000110000011100000001111111
11110111111111011100000000001
11110111111111011101010000001
11000000110101011100000000001
10000000000000001100000010001
10000000000000001101010010001
1000000111010101111101111000111
10000001 1110101 101111010001
11111111 1111111 111111111111