NO       sprite/mossy.png

SO           sprite/colorstone.png
WE       sprite/redbrick.png
EA sprite/wood.png
C         225,30,0
F         220,100,0




111111111
100000001
111000011
1100N0011
111000011
111111111
111111111