NO       ./path_to_the_north_texture

SO           ./path_to_the_south_texture
F         220,100,0
WE       ./path_to_the_west_texture
C         225,30,0

EA ./path_to_the_east_texture



111111111
111111111
111000011
1100N0011
111000011
111111111
111111111