NO       sprite/mossy.png

SO           sprite/colorstone.png
WE       sprite/redbrick.png
EA sprite/wood.png
C         20,83,150
F         225,245,0


        1111111111111111111111111
        1000000000110000000000001
        1011000001110000000000001
        100100000000000000N000001
111111111011000001110000000000001
100000000011000001110000000111111
11110111111111011100000000001
11110111111111011101010000001
11000000110101011100000000001
10000000000000001100000010001
10000000000000001101010010001
1000000111010101111101111000111
10000001 1110101 101111010001
11111111 1111111 111111111111